[. . . . . . . . ...]
[                   ]
[.                  ]
[                   ]
[.                  ]
[                   ]
[.                  ]
[                   ]
[.                  ]
[                   ]
[.                  ]
[                   ]
[.                  ]
[                   ]
[.                  ]
[                   ]
[.                  ]
[.                  ]
[.                  ]