[    .......    ]
[  ...........  ]
[ ............. ]
[ ............. ]
[ ............. ]
[ ..............]
[ ..............]
[ ..............]
[ ..............]
[ ..   .........]
[ ..     ...... ]
[ ...    ...... ]
[ ............. ]
[  ...........  ]
[               ]