[    .......    ]
[ ............. ]
[ ............. ]
[ ............. ]
[ ............. ]
[ ..............]
[ ..............]
[ ..............]
[ ..............]
[ ..   .........]
[ .. . ........ ]
[ ..   ........ ]
[ ............. ]
[ ............. ]
[               ]