[    .......    ]
[ ............. ]
[ ............. ]
[ ............. ]
[ ............. ]
[ ..............]
[ ..      ......]
[ ..      ......]
[ ..  ..  ......]
[ ..  ..  ......]
[ ..      ..... ]
[ ..      ..... ]
[ ............. ]
[ ............. ]
[               ]