[    .......    ]
[ ............. ]
[ ............. ]
[ ............. ]
[ ............. ]
[ ..............]
[ ..............]
[ ..............]
[ ..............]
[ ..............]
[ ............. ]
[ ............. ]
[ ............. ]
[ ............. ]
[               ]