[    .......    ]
[ ............. ]
[ ............. ]
[ ............. ]
[ ............. ]
[ ..............]
[ ..............]
[ ..............]
[ ..    ........]
[ .. .. ........]
[ .. .. ....... ]
[ ..    ....... ]
[ ............. ]
[ ............. ]
[               ]